#....................................................#
#....................................................#
#....................................................#
#....................................................#
#....................#####...........................#
#.......................................##...........#
#...............##..........###...##..........##.....#
#..##..###..##.......................................#
#..................................................###
#.............................###....................#
##....##.............................................#
#....................##....##......##....##....##....#
#....................................................#
#........##....##....................................#
#....................................................#
#..........##.....##.................................#
#.................................................#..#
#...........##........#...#...#..#...................#
#...#................................................#
#.....####.........................#..#####...###....#
#.....#......................##......................#
#.....#....."........................#...............#
#"..........#........................................#
##......."""#".....P......."...""""".................#
##"""""""#####"""""""""""""#"""#####"""""""""""""""""#